Karachi	Thatta
Thatta	Jamshoro
Jamshoro	Hyderabad
Hyderabad	Hala
Hala	Moro
Moro	Ranipur
Ranipur	Khairpur
Khairpur	Rohri
Rohri	Ghotki
Ghotki	Ubauro
Ubauro	Bahawalpur
Bahawalpur	Lodhran
Lodhran	Multan
Multan	Khanewal
Khanewal	MianChannu
MianChannu	Sahiwal
Sahiwal	Okara
Okara	Pattoki
Pattoki	Lahore
Lahore	Muridke
Muridke	Kamoke
Kamoke	Gujranwala
Gujranwala	Wazirabad
Wazirabad	Gujrat
Gujrat	Jhelum
Jhelum	Rawalpindi
Rawalpindi	Nowshera
Nowshera	Peshawar
Peshawar	Torkham
Winder	Ormara
Ormara	Pasni
Pasni	Gawadar
Mansehra	Naran
Naran	Jalkhad
Jalkhad	Chilas
Karachi	hub
hub	Winder
Winder	Uthal
Uthal	Bela
Bela	Khuzdar
Khuzdar	Surab
Surab	Kalat
Kalat	Mastung
Mastung	Quetta
Quetta	kuchlak
kuchlak	Chaman
Basima	Khuzdar
HasanAbdal	Abbottabad
Abbottabad	Mansehra
Chilas	Aliabad
Aliabad	KhunjerabPass
Quetta	Nushki
Nushki	Dalbadin
Dalbadin	Taftan
Nowshera	Mardan
Mardan	Batkhela
Batkhela	Timergara
Timergara	Chitral
Kuchlak	QilaSaifullah
QilaSaifullah	Zhob
Zhob	DIKhan
Kotri	Jamshoro
Jamshoro	Dadu
Dadu	Larkana
Larkana	Shikarpur
Shikarpur	Kandhkot
Kandhkot	Rajanpur
Rajanpur	DGKhan
DGKhan	DIKhan
DIKhan	Kohat
Kohat	Peshawar
Sibi	DeraMuradJamali
DeraMuradJamali	Jacobabad
Jacobabad	Shikarpur
Shikarpur	Sukkur
QilaSaifullah	Loralai
Loralai	Mekhtar
Mekhtar	FortMonro
FortMonro	DGKhan
DGKhan	Muzaffargarh
Muzaffargarh	Multan
Islamabad	Kohala
Islamabad	Kohat
Hoshab	Basima
Basima	Surab
Khwazakhela	Besham
Chakdara	Kalam
Larkana	Lakhi
Gharo	MirpurSakro
MirpurSakro	KetiBunder
Hyderabad	MirpurKhas
MirpurKhas	UmerKot
UmerKot	Khokhrapar
Taxila	Khanpur
Khanpur	Haripur
Larkana	MohenjoDaro
Larkana	RasheedWagan
RasheedWagan	Nasirabad
Sakrand	Nawabshah
Larkana	Shahdadkot
Ratodero	Naudero
