N-55	M-1	2
KhyberAgency	M-1	2
Mohmand	M-1	2
Peshawar	Jamrud	1
Jamrud	Landikotal	1
Landikotal	Torkham	1
Wazirabad	Hafizabad	3
Hafizabad	KotSarwar	3
Khanewal	Lodhran	5
Sukkur	Jacobabad	6
Ratodero	Sehwan	6B
Islamabad	Murree	75
Murree	Kohala	75
Besham	Karora	90
Karora	Alpuri	90
Alpuri	Khwazakhela	90
Nowshera	Swabi	SwatExpy
Swabi	Mardan	SwatExpy
Mardan	Chakdara	SwatExpy
Sahianwala	GatwalaChowk	CanalExpy
SohrabGoth	SirShahSuleman	LyariExpy
SirShahSuleman	Manghopir	LyariExpy
Manghopir	Mauripur	LyariExpy
N-10	Gawadar	EastBayExpy
